..........
#.....A...
.AB.......
..A...A...
...#......
